Txn Date,"ValueDate",Description,"Ref No./ChequeNo.",Debit,Credit,Balance
1 Jun 2021,1 Jun 2021,"BULK POSTING-EPFOPENSION MAY 2021-",,,"1,434.00","1,461.93"
4 Jun 2021,4 Jun 2021,"ATM WDL-ATM CASH 11550NIT ROAD ,ADITYAPUR    WSINGHBHUM-",,"1,000.00",,461.93
"20 Jun2021","20 Jun2021","BY TRANSFER-INBIMPS117119116166/9348103094/XX9559/-","MAC000758622606MAC000758622606",,50.00,511.93
"21 Jun2021","21 Jun2021","ATM WDL-ATM CASH 11720NIT ROAD ,ADITYAPUR    WSINGHBHUM-",,500.00,,11.93
"25 Jun2021","25 Jun2021",CREDIT INTEREST--,,,3.00,14.93
"30 Jun2021","30 Jun2021","BY TRANSFER-INBIMPS118116559128/9348103094/XX9559/-","MAA000803778366MAA000803778366",,"9,500.00","9,514.93"
