Txn Date,"ValueDate",Description,"Ref No./ChequeNo.",Debit,Credit,Balance
1 Aug 2021,1 Aug 2021,"BY TRANSFER-INBIMPS121309234861/9348103094/XX9559/-","MAC000792913614MAC000792913614",,"9,000.00","9,011.93"
1 Aug 2021,1 Aug 2021,"ATM WDL-ATM CASH 9029NEAR ADHARSHILAADITYAKHARSAWAN-",,"9,000.00",,11.93
2 Aug 2021,2 Aug 2021,BULK POSTING-BY SALARY-,,,"1,434.00","1,445.93"
4 Aug 2021,4 Aug 2021,"ATM WDL-ATM CASH 3198ADHARSHILATOWER,ADITYKHARSAWAN-",,"1,000.00",,445.93
"10 Aug2021","10 Aug2021","BY TRANSFER-INBIMPS122213542146/9348103094/XX5042/Remarks-","MAC000801840393MAC000801840393",,100.00,545.93
"10 Aug2021","10 Aug2021","ATM WDL-ATM CASH 12221NIT ROAD ,ADITYAPUR    WSINGHBHUM-",,500.00,,45.93
